N
16,24
C
100
A
24
2,21,S
5,8
3,21,S
6,8
12,21,S
7,8
13,21,S
8,8
2,20,S
9,8
3,20,S
10,8
12,20,S
5,10
13,20,S
6,10
2,19,S
7,10
3,19,S
8,10
12,19,S
9,10
13,19,S
10,10
2,2,N
5,13
3,2,N
6,13
12,2,N
7,13
13,2,N
8,13
2,3,N
9,13
3,3,N
10,13
12,3,N
5,15
13,3,N
6,15
2,4,N
7,15
3,4,N
8,15
12,4,N
9,15
13,4,N
10,15
M
100,100,100,100,100,100,100,100,100,100,100,100,100,100,100,100
100,100,100,100,100,100,100,100,100,100,100,100,100,100,100,100
100,100,0,0,100,100,100,100,100,100,100,100,0,0,100,100
100,100,0,0,100,100,100,100,100,100,100,100,0,0,100,100
100,100,0,0,100,100,100,100,100,100,100,100,0,0,100,100
100,100,0,0,100,100,100,100,100,100,100,100,0,0,100,100
100,100,0,0,0,0,0,0,0,0,0,0,0,0,100,100
100,100,0,0,0,0,0,0,0,0,0,0,0,0,100,100
100,100,0,0,100,1,1,1,1,1,1,100,0,0,100,100
100,100,0,0,100,100,100,100,100,100,100,100,0,0,100,100
100,100,0,0,100,1,1,1,1,1,1,100,0,0,100,100
100,100,0,0,0,0,0,0,0,0,0,0,0,0,100,100
100,100,0,0,0,0,0,0,0,0,0,0,0,0,100,100
100,100,0,0,100,1,1,1,1,1,1,100,0,0,100,100
100,100,0,0,100,100,100,100,100,100,100,100,0,0,100,100
100,100,0,0,100,1,1,1,1,1,1,100,0,0,100,100
100,100,0,0,0,0,0,0,0,0,0,0,0,0,100,100
100,100,0,0,0,0,0,0,0,0,0,0,0,0,100,100
100,100,0,0,100,100,100,100,100,100,100,100,0,0,100,100
100,100,0,0,100,100,100,100,100,100,100,100,0,0,100,100
100,100,0,0,100,100,100,100,100,100,100,100,0,0,100,100
100,100,0,0,100,100,100,100,100,100,100,100,0,0,100,100
100,100,100,100,100,100,100,100,100,100,100,100,100,100,100,100
100,100,100,100,100,100,100,100,100,100,100,100,100,100,100,100
