N
28,64
C
100
A
100
2,56,N
5,11
24,62,N
13,14
24,46,N
22,21
24,48,N
6,21
3,49,N
16,16
25,55,N
14,19
24,57,N
5,9
24,58,N
18,11
2,36,N
22,6
2,61,N
14,11
25,62,N
15,21
25,58,N
6,19
25,50,N
17,16
25,49,N
7,16
3,31,N
7,11
24,28,N
14,21
24,51,N
5,21
25,41,N
16,4
25,43,N
11,16
3,41,N
11,4
3,46,N
7,19
3,50,N
19,4
25,28,N
6,6
25,29,N
21,21
25,45,N
7,6
24,29,N
18,21
25,38,N
20,14
25,36,N
20,21
2,63,N
9,14
3,39,N
13,4
3,34,N
18,9
2,58,N
17,9
2,32,N
12,19
24,50,N
10,11
25,53,N
12,21
24,34,N
19,6
25,59,N
21,11
25,57,N
6,4
24,35,N
17,21
3,36,N
9,21
3,60,N
19,19
25,61,N
20,16
2,51,N
19,11
2,60,N
22,19
3,52,N
21,6
2,52,N
13,16
3,44,N
15,14
3,55,N
12,9
3,62,N
18,16
3,40,N
6,9
24,49,N
6,11
2,46,N
16,19
25,60,N
9,11
3,38,N
5,4
24,61,N
20,6
3,28,N
15,11
3,54,N
9,6
2,43,N
21,14
25,44,N
18,4
24,52,N
17,19
3,45,N
7,9
2,57,N
14,14
24,30,N
19,14
25,40,N
10,14
3,56,N
12,6
25,42,N
18,19
2,34,N
16,9
3,42,N
19,16
2,38,N
20,11
24,41,N
11,21
25,30,N
5,16
24,40,N
10,9
2,42,N
13,11
2,35,N
7,4
25,52,N
10,16
25,39,N
15,9
3,29,N
8,9
24,55,N
17,6
3,61,N
12,4
3,58,N
17,11
25,56,N
15,4
3,37,N
10,4
2,44,N
15,19
24,43,N
18,6
3,59,N
21,9
2,53,N
9,4
24,39,N
9,19
3,32,N
14,16
24,60,N
10,19
2,37,N
11,19
2,41,N
13,19
3,51,N
11,9
2,50,N
12,16
25,63,N
7,21
25,31,N
13,21
24,63,N
21,4
24,33,N
22,14
3,57,N
16,14
24,31,N
14,6
2,62,N
18,14
M
100,100,100,100,100,100,100,100,100,100,100,100,100,100,100,100,100,100,100,100,100,100,100,100,100,100,100,100
100,100,100,100,100,100,100,100,100,100,100,100,100,100,100,100,100,100,100,100,100,100,100,100,100,100,100,100
100,100,0,0,0,0,0,0,0,0,0,0,0,0,0,0,0,0,0,0,0,0,0,0,0,0,100,100
100,100,0,0,0,0,0,0,0,0,0,0,0,0,0,0,0,0,0,0,0,0,0,0,0,0,100,100
100,100,0,0,100,1,1,1,1,1,1,1,1,1,1,1,1,1,1,1,1,1,1,100,0,0,100,100
100,100,0,0,100,100,100,100,100,100,100,100,100,100,100,100,100,100,100,100,100,100,100,100,0,0,100,100
100,100,0,0,100,1,1,1,1,1,1,1,1,1,1,1,1,1,1,1,1,1,1,100,0,0,100,100
100,100,0,0,0,0,0,0,0,0,0,0,0,0,0,0,0,0,0,0,0,0,0,0,0,0,100,100
100,100,0,0,0,0,0,0,0,0,0,0,0,0,0,0,0,0,0,0,0,0,0,0,0,0,100,100
100,100,0,0,100,1,1,1,1,1,1,1,1,1,1,1,1,1,1,1,1,1,1,100,0,0,100,100
100,100,0,0,100,100,100,100,100,100,100,100,100,100,100,100,100,100,100,100,100,100,100,100,0,0,100,100
100,100,0,0,100,1,1,1,1,1,1,1,1,1,1,1,1,1,1,1,1,1,1,100,0,0,100,100
100,100,0,0,0,0,0,0,0,0,0,0,0,0,0,0,0,0,0,0,0,0,0,0,0,0,100,100
100,100,0,0,0,0,0,0,0,0,0,0,0,0,0,0,0,0,0,0,0,0,0,0,0,0,100,100
100,100,0,0,100,1,1,1,1,1,1,1,1,1,1,1,1,1,1,1,1,1,1,100,0,0,100,100
100,100,0,0,100,100,100,100,100,100,100,100,100,100,100,100,100,100,100,100,100,100,100,100,0,0,100,100
100,100,0,0,100,1,1,1,1,1,1,1,1,1,1,1,1,1,1,1,1,1,1,100,0,0,100,100
100,100,0,0,0,0,0,0,0,0,0,0,0,0,0,0,0,0,0,0,0,0,0,0,0,0,100,100
100,100,0,0,0,0,0,0,0,0,0,0,0,0,0,0,0,0,0,0,0,0,0,0,0,0,100,100
100,100,0,0,100,1,1,1,1,1,1,1,1,1,1,1,1,1,1,1,1,1,1,100,0,0,100,100
100,100,0,0,100,100,100,100,100,100,100,100,100,100,100,100,100,100,100,100,100,100,100,100,0,0,100,100
100,100,0,0,100,1,1,1,1,1,1,1,1,1,1,1,1,1,1,1,1,1,1,100,0,0,100,100
100,100,0,0,0,0,0,0,0,0,0,0,0,0,0,0,0,0,0,0,0,0,0,0,0,0,100,100
100,100,0,0,0,0,0,0,0,0,0,0,0,0,0,0,0,0,0,0,0,0,0,0,0,0,100,100
100,100,0,0,100,100,100,100,100,100,100,100,100,100,100,100,100,100,100,100,100,100,100,100,0,0,100,100
100,100,0,0,100,100,100,100,100,100,100,100,100,100,100,100,100,100,100,100,100,100,100,100,0,0,100,100
100,100,0,0,100,100,100,100,100,100,100,100,100,100,100,100,100,100,100,100,100,100,100,100,0,0,100,100
100,100,0,0,100,100,100,100,100,100,100,100,100,100,100,100,100,100,100,100,100,100,100,100,0,0,100,100
100,100,0,0,100,100,100,100,100,100,100,100,100,100,100,100,100,100,100,100,100,100,100,100,0,0,100,100
100,100,0,0,100,100,100,100,100,100,100,100,100,100,100,100,100,100,100,100,100,100,100,100,0,0,100,100
100,100,0,0,100,100,100,100,100,100,100,100,100,100,100,100,100,100,100,100,100,100,100,100,0,0,100,100
100,100,0,0,100,100,100,100,100,100,100,100,100,100,100,100,100,100,100,100,100,100,100,100,0,0,100,100
100,100,0,0,100,100,100,100,100,100,100,100,100,100,100,100,100,100,100,100,100,100,100,100,0,0,100,100
100,100,0,0,100,100,100,100,100,100,100,100,100,100,100,100,100,100,100,100,100,100,100,100,0,0,100,100
100,100,0,0,100,100,100,100,100,100,100,100,100,100,100,100,100,100,100,100,100,100,100,100,0,0,100,100
100,100,0,0,100,100,100,100,100,100,100,100,100,100,100,100,100,100,100,100,100,100,100,100,0,0,100,100
100,100,0,0,100,100,100,100,100,100,100,100,100,100,100,100,100,100,100,100,100,100,100,100,0,0,100,100
100,100,0,0,100,100,100,100,100,100,100,100,100,100,100,100,100,100,100,100,100,100,100,100,0,0,100,100
100,100,0,0,100,100,100,100,100,100,100,100,100,100,100,100,100,100,100,100,100,100,100,100,0,0,100,100
100,100,0,0,100,100,100,100,100,100,100,100,100,100,100,100,100,100,100,100,100,100,100,100,0,0,100,100
100,100,0,0,100,100,100,100,100,100,100,100,100,100,100,100,100,100,100,100,100,100,100,100,0,0,100,100
100,100,0,0,100,100,100,100,100,100,100,100,100,100,100,100,100,100,100,100,100,100,100,100,0,0,100,100
100,100,0,0,100,100,100,100,100,100,100,100,100,100,100,100,100,100,100,100,100,100,100,100,0,0,100,100
100,100,0,0,100,100,100,100,100,100,100,100,100,100,100,100,100,100,100,100,100,100,100,100,0,0,100,100
100,100,0,0,100,100,100,100,100,100,100,100,100,100,100,100,100,100,100,100,100,100,100,100,0,0,100,100
100,100,0,0,100,100,100,100,100,100,100,100,100,100,100,100,100,100,100,100,100,100,100,100,0,0,100,100
100,100,0,0,100,100,100,100,100,100,100,100,100,100,100,100,100,100,100,100,100,100,100,100,0,0,100,100
100,100,0,0,100,100,100,100,100,100,100,100,100,100,100,100,100,100,100,100,100,100,100,100,0,0,100,100
100,100,0,0,100,100,100,100,100,100,100,100,100,100,100,100,100,100,100,100,100,100,100,100,0,0,100,100
100,100,0,0,100,100,100,100,100,100,100,100,100,100,100,100,100,100,100,100,100,100,100,100,0,0,100,100
100,100,0,0,100,100,100,100,100,100,100,100,100,100,100,100,100,100,100,100,100,100,100,100,0,0,100,100
100,100,0,0,100,100,100,100,100,100,100,100,100,100,100,100,100,100,100,100,100,100,100,100,0,0,100,100
100,100,0,0,100,100,100,100,100,100,100,100,100,100,100,100,100,100,100,100,100,100,100,100,0,0,100,100
100,100,0,0,100,100,100,100,100,100,100,100,100,100,100,100,100,100,100,100,100,100,100,100,0,0,100,100
100,100,0,0,100,100,100,100,100,100,100,100,100,100,100,100,100,100,100,100,100,100,100,100,0,0,100,100
100,100,0,0,100,100,100,100,100,100,100,100,100,100,100,100,100,100,100,100,100,100,100,100,0,0,100,100
100,100,0,0,100,100,100,100,100,100,100,100,100,100,100,100,100,100,100,100,100,100,100,100,0,0,100,100
100,100,0,0,100,100,100,100,100,100,100,100,100,100,100,100,100,100,100,100,100,100,100,100,0,0,100,100
100,100,0,0,100,100,100,100,100,100,100,100,100,100,100,100,100,100,100,100,100,100,100,100,0,0,100,100
100,100,0,0,100,100,100,100,100,100,100,100,100,100,100,100,100,100,100,100,100,100,100,100,0,0,100,100
100,100,0,0,100,100,100,100,100,100,100,100,100,100,100,100,100,100,100,100,100,100,100,100,0,0,100,100
100,100,0,0,100,100,100,100,100,100,100,100,100,100,100,100,100,100,100,100,100,100,100,100,0,0,100,100
100,100,0,0,100,100,100,100,100,100,100,100,100,100,100,100,100,100,100,100,100,100,100,100,0,0,100,100
100,100,0,0,100,100,100,100,100,100,100,100,100,100,100,100,100,100,100,100,100,100,100,100,0,0,100,100
