N
28,64
C
100
A
144
2,56,N
9,9
24,62,N
13,19
24,46,N
5,4
24,48,N
18,11
3,49,N
7,21
25,55,N
14,9
24,57,N
8,21
24,58,N
14,6
2,36,N
9,14
2,61,N
16,21
25,62,N
19,9
25,58,N
8,9
25,50,N
10,16
25,49,N
10,9
3,31,N
20,21
24,28,N
15,14
24,51,N
22,19
25,41,N
7,4
25,43,N
19,4
3,41,N
15,19
3,46,N
15,9
3,50,N
9,19
25,28,N
21,16
25,29,N
18,16
25,45,N
11,21
24,29,N
17,6
25,38,N
12,4
25,36,N
21,19
2,63,N
19,19
3,39,N
5,14
3,34,N
15,4
2,58,N
10,19
2,32,N
8,16
24,50,N
13,11
25,53,N
19,16
24,34,N
13,4
25,59,N
12,16
25,57,N
19,11
24,35,N
13,16
3,36,N
21,4
3,60,N
6,19
25,61,N
17,14
2,51,N
11,11
2,60,N
21,11
3,52,N
8,6
2,52,N
20,6
3,44,N
19,21
3,55,N
10,14
3,62,N
5,11
3,40,N
15,21
24,49,N
20,11
2,46,N
21,14
25,60,N
12,6
3,38,N
16,19
24,61,N
20,9
3,28,N
18,14
3,54,N
16,14
2,43,N
16,9
25,44,N
7,11
24,52,N
17,11
3,45,N
8,11
2,57,N
20,4
24,30,N
18,6
25,40,N
15,6
3,56,N
5,19
25,42,N
12,9
2,34,N
5,21
3,42,N
8,14
2,38,N
15,16
24,41,N
16,6
25,30,N
13,14
24,40,N
13,21
2,42,N
14,4
2,35,N
14,19
25,52,N
7,14
25,39,N
12,14
3,29,N
9,4
24,55,N
11,9
3,61,N
22,11
3,58,N
21,21
25,56,N
22,6
3,37,N
17,16
2,44,N
14,14
24,43,N
18,4
3,59,N
21,6
2,53,N
18,19
24,39,N
20,19
3,32,N
7,16
24,60,N
5,9
2,37,N
6,11
2,41,N
15,11
3,51,N
18,21
2,50,N
12,21
25,63,N
22,9
25,31,N
13,6
24,63,N
17,4
24,33,N
11,4
3,57,N
19,14
24,31,N
7,19
2,62,N
9,16
3,35,N
9,6
2,54,N
13,9
25,33,N
18,9
24,36,N
8,19
25,48,N
8,4
25,46,N
20,14
3,48,N
5,16
3,47,N
6,16
2,59,N
14,16
3,43,N
7,9
24,32,N
21,9
2,49,N
17,9
24,37,N
19,6
3,33,N
22,4
24,59,N
6,21
25,34,N
22,16
24,38,N
16,16
3,30,N
10,4
2,33,N
9,11
2,55,N
22,21
2,39,N
14,21
24,45,N
11,16
3,63,N
11,6
25,32,N
22,14
24,54,N
6,9
24,42,N
6,4
2,45,N
7,6
2,29,N
11,19
24,56,N
11,14
2,31,N
14,11
24,53,N
12,11
25,47,N
6,6
24,47,N
20,16
25,37,N
10,11
25,54,N
10,6
25,35,N
16,11
2,47,N
17,21
24,44,N
12,19
2,28,N
10,21
2,48,N
17,19
25,51,N
5,6
2,40,N
9,21
2,30,N
6,14
3,53,N
16,4
M
100,100,100,100,100,100,100,100,100,100,100,100,100,100,100,100,100,100,100,100,100,100,100,100,100,100,100,100
100,100,100,100,100,100,100,100,100,100,100,100,100,100,100,100,100,100,100,100,100,100,100,100,100,100,100,100
100,100,0,0,0,0,0,0,0,0,0,0,0,0,0,0,0,0,0,0,0,0,0,0,0,0,100,100
100,100,0,0,0,0,0,0,0,0,0,0,0,0,0,0,0,0,0,0,0,0,0,0,0,0,100,100
100,100,0,0,100,1,1,1,1,1,1,1,1,1,1,1,1,1,1,1,1,1,1,100,0,0,100,100
100,100,0,0,100,100,100,100,100,100,100,100,100,100,100,100,100,100,100,100,100,100,100,100,0,0,100,100
100,100,0,0,100,1,1,1,1,1,1,1,1,1,1,1,1,1,1,1,1,1,1,100,0,0,100,100
100,100,0,0,0,0,0,0,0,0,0,0,0,0,0,0,0,0,0,0,0,0,0,0,0,0,100,100
100,100,0,0,0,0,0,0,0,0,0,0,0,0,0,0,0,0,0,0,0,0,0,0,0,0,100,100
100,100,0,0,100,1,1,1,1,1,1,1,1,1,1,1,1,1,1,1,1,1,1,100,0,0,100,100
100,100,0,0,100,100,100,100,100,100,100,100,100,100,100,100,100,100,100,100,100,100,100,100,0,0,100,100
100,100,0,0,100,1,1,1,1,1,1,1,1,1,1,1,1,1,1,1,1,1,1,100,0,0,100,100
100,100,0,0,0,0,0,0,0,0,0,0,0,0,0,0,0,0,0,0,0,0,0,0,0,0,100,100
100,100,0,0,0,0,0,0,0,0,0,0,0,0,0,0,0,0,0,0,0,0,0,0,0,0,100,100
100,100,0,0,100,1,1,1,1,1,1,1,1,1,1,1,1,1,1,1,1,1,1,100,0,0,100,100
100,100,0,0,100,100,100,100,100,100,100,100,100,100,100,100,100,100,100,100,100,100,100,100,0,0,100,100
100,100,0,0,100,1,1,1,1,1,1,1,1,1,1,1,1,1,1,1,1,1,1,100,0,0,100,100
100,100,0,0,0,0,0,0,0,0,0,0,0,0,0,0,0,0,0,0,0,0,0,0,0,0,100,100
100,100,0,0,0,0,0,0,0,0,0,0,0,0,0,0,0,0,0,0,0,0,0,0,0,0,100,100
100,100,0,0,100,1,1,1,1,1,1,1,1,1,1,1,1,1,1,1,1,1,1,100,0,0,100,100
100,100,0,0,100,100,100,100,100,100,100,100,100,100,100,100,100,100,100,100,100,100,100,100,0,0,100,100
100,100,0,0,100,1,1,1,1,1,1,1,1,1,1,1,1,1,1,1,1,1,1,100,0,0,100,100
100,100,0,0,0,0,0,0,0,0,0,0,0,0,0,0,0,0,0,0,0,0,0,0,0,0,100,100
100,100,0,0,0,0,0,0,0,0,0,0,0,0,0,0,0,0,0,0,0,0,0,0,0,0,100,100
100,100,0,0,100,100,100,100,100,100,100,100,100,100,100,100,100,100,100,100,100,100,100,100,0,0,100,100
100,100,0,0,100,100,100,100,100,100,100,100,100,100,100,100,100,100,100,100,100,100,100,100,0,0,100,100
100,100,0,0,100,100,100,100,100,100,100,100,100,100,100,100,100,100,100,100,100,100,100,100,0,0,100,100
100,100,0,0,100,100,100,100,100,100,100,100,100,100,100,100,100,100,100,100,100,100,100,100,0,0,100,100
100,100,0,0,100,100,100,100,100,100,100,100,100,100,100,100,100,100,100,100,100,100,100,100,0,0,100,100
100,100,0,0,100,100,100,100,100,100,100,100,100,100,100,100,100,100,100,100,100,100,100,100,0,0,100,100
100,100,0,0,100,100,100,100,100,100,100,100,100,100,100,100,100,100,100,100,100,100,100,100,0,0,100,100
100,100,0,0,100,100,100,100,100,100,100,100,100,100,100,100,100,100,100,100,100,100,100,100,0,0,100,100
100,100,0,0,100,100,100,100,100,100,100,100,100,100,100,100,100,100,100,100,100,100,100,100,0,0,100,100
100,100,0,0,100,100,100,100,100,100,100,100,100,100,100,100,100,100,100,100,100,100,100,100,0,0,100,100
100,100,0,0,100,100,100,100,100,100,100,100,100,100,100,100,100,100,100,100,100,100,100,100,0,0,100,100
100,100,0,0,100,100,100,100,100,100,100,100,100,100,100,100,100,100,100,100,100,100,100,100,0,0,100,100
100,100,0,0,100,100,100,100,100,100,100,100,100,100,100,100,100,100,100,100,100,100,100,100,0,0,100,100
100,100,0,0,100,100,100,100,100,100,100,100,100,100,100,100,100,100,100,100,100,100,100,100,0,0,100,100
100,100,0,0,100,100,100,100,100,100,100,100,100,100,100,100,100,100,100,100,100,100,100,100,0,0,100,100
100,100,0,0,100,100,100,100,100,100,100,100,100,100,100,100,100,100,100,100,100,100,100,100,0,0,100,100
100,100,0,0,100,100,100,100,100,100,100,100,100,100,100,100,100,100,100,100,100,100,100,100,0,0,100,100
100,100,0,0,100,100,100,100,100,100,100,100,100,100,100,100,100,100,100,100,100,100,100,100,0,0,100,100
100,100,0,0,100,100,100,100,100,100,100,100,100,100,100,100,100,100,100,100,100,100,100,100,0,0,100,100
100,100,0,0,100,100,100,100,100,100,100,100,100,100,100,100,100,100,100,100,100,100,100,100,0,0,100,100
100,100,0,0,100,100,100,100,100,100,100,100,100,100,100,100,100,100,100,100,100,100,100,100,0,0,100,100
100,100,0,0,100,100,100,100,100,100,100,100,100,100,100,100,100,100,100,100,100,100,100,100,0,0,100,100
100,100,0,0,100,100,100,100,100,100,100,100,100,100,100,100,100,100,100,100,100,100,100,100,0,0,100,100
100,100,0,0,100,100,100,100,100,100,100,100,100,100,100,100,100,100,100,100,100,100,100,100,0,0,100,100
100,100,0,0,100,100,100,100,100,100,100,100,100,100,100,100,100,100,100,100,100,100,100,100,0,0,100,100
100,100,0,0,100,100,100,100,100,100,100,100,100,100,100,100,100,100,100,100,100,100,100,100,0,0,100,100
100,100,0,0,100,100,100,100,100,100,100,100,100,100,100,100,100,100,100,100,100,100,100,100,0,0,100,100
100,100,0,0,100,100,100,100,100,100,100,100,100,100,100,100,100,100,100,100,100,100,100,100,0,0,100,100
100,100,0,0,100,100,100,100,100,100,100,100,100,100,100,100,100,100,100,100,100,100,100,100,0,0,100,100
100,100,0,0,100,100,100,100,100,100,100,100,100,100,100,100,100,100,100,100,100,100,100,100,0,0,100,100
100,100,0,0,100,100,100,100,100,100,100,100,100,100,100,100,100,100,100,100,100,100,100,100,0,0,100,100
100,100,0,0,100,100,100,100,100,100,100,100,100,100,100,100,100,100,100,100,100,100,100,100,0,0,100,100
100,100,0,0,100,100,100,100,100,100,100,100,100,100,100,100,100,100,100,100,100,100,100,100,0,0,100,100
100,100,0,0,100,100,100,100,100,100,100,100,100,100,100,100,100,100,100,100,100,100,100,100,0,0,100,100
100,100,0,0,100,100,100,100,100,100,100,100,100,100,100,100,100,100,100,100,100,100,100,100,0,0,100,100
100,100,0,0,100,100,100,100,100,100,100,100,100,100,100,100,100,100,100,100,100,100,100,100,0,0,100,100
100,100,0,0,100,100,100,100,100,100,100,100,100,100,100,100,100,100,100,100,100,100,100,100,0,0,100,100
100,100,0,0,100,100,100,100,100,100,100,100,100,100,100,100,100,100,100,100,100,100,100,100,0,0,100,100
100,100,0,0,100,100,100,100,100,100,100,100,100,100,100,100,100,100,100,100,100,100,100,100,0,0,100,100
100,100,0,0,100,100,100,100,100,100,100,100,100,100,100,100,100,100,100,100,100,100,100,100,0,0,100,100
