N
80,64
C
100
A
144
2,63,N
6,6
3,63,N
10,6
76,63,N
14,6
77,63,N
18,6
2,62,N
22,6
3,62,N
26,6
76,62,N
30,6
77,62,N
34,6
2,61,N
38,6
3,61,N
42,6
76,61,N
46,6
77,61,N
50,6
2,60,N
54,6
3,60,N
58,6
76,60,N
62,6
77,60,N
66,6
2,59,N
70,6
3,59,N
74,6
76,59,N
6,12
77,59,N
10,12
2,58,N
14,12
3,58,N
18,12
76,58,N
22,12
77,58,N
26,12
2,57,N
30,12
3,57,N
34,12
76,57,N
38,12
77,57,N
42,12
2,56,N
46,12
3,56,N
50,12
76,56,N
54,12
77,56,N
58,12
2,55,N
62,12
3,55,N
66,12
76,55,N
70,12
77,55,N
74,12
2,54,N
6,19
3,54,N
10,19
76,54,N
14,19
77,54,N
18,19
2,53,N
22,19
3,53,N
26,19
76,53,N
30,19
77,53,N
34,19
2,52,N
38,19
3,52,N
42,19
76,52,N
46,19
77,52,N
50,19
2,51,N
54,19
3,51,N
58,19
76,51,N
62,19
77,51,N
66,19
2,50,N
70,19
3,50,N
74,19
76,50,N
6,25
77,50,N
10,25
2,49,N
14,25
3,49,N
18,25
76,49,N
22,25
77,49,N
26,25
2,48,N
30,25
3,48,N
34,25
76,48,N
38,25
77,48,N
42,25
2,47,N
46,25
3,47,N
50,25
76,47,N
54,25
77,47,N
58,25
2,46,N
62,25
3,46,N
66,25
76,46,N
70,25
77,46,N
74,25
2,45,N
6,32
3,45,N
10,32
76,45,N
14,32
77,45,N
18,32
2,44,N
22,32
3,44,N
26,32
76,44,N
30,32
77,44,N
34,32
2,43,N
38,32
3,43,N
42,32
76,43,N
46,32
77,43,N
50,32
2,42,N
54,32
3,42,N
58,32
76,42,N
62,32
77,42,N
66,32
2,41,N
70,32
3,41,N
74,32
76,41,N
6,38
77,41,N
10,38
2,40,N
14,38
3,40,N
18,38
76,40,N
22,38
77,40,N
26,38
2,39,N
30,38
3,39,N
34,38
76,39,N
38,38
77,39,N
42,38
2,38,N
46,38
3,38,N
50,38
76,38,N
54,38
77,38,N
58,38
2,37,N
62,38
3,37,N
66,38
76,37,N
70,38
77,37,N
74,38
2,36,N
6,45
3,36,N
10,45
76,36,N
14,45
77,36,N
18,45
2,35,N
22,45
3,35,N
26,45
76,35,N
30,45
77,35,N
34,45
2,34,N
38,45
3,34,N
42,45
76,34,N
46,45
77,34,N
50,45
2,33,N
54,45
3,33,N
58,45
76,33,N
62,45
77,33,N
66,45
2,32,N
70,45
3,32,N
74,45
76,32,N
6,51
77,32,N
10,51
2,31,N
14,51
3,31,N
18,51
76,31,N
22,51
77,31,N
26,51
2,30,N
30,51
3,30,N
34,51
76,30,N
38,51
77,30,N
42,51
2,29,N
46,51
3,29,N
50,51
76,29,N
54,51
77,29,N
58,51
2,28,N
62,51
3,28,N
66,51
76,28,N
70,51
77,28,N
74,51
M
100,100,100,100,100,100,100,100,100,100,100,100,100,100,100,100,100,100,100,100,100,100,100,100,100,100,100,100,100,100,100,100,100,100,100,100,100,100,100,100,100,100,100,100,100,100,100,100,100,100,100,100,100,100,100,100,100,100,100,100,100,100,100,100,100,100,100,100,100,100,100,100,100,100,100,100,100,100,100,100
100,100,100,100,100,100,100,100,100,100,100,100,100,100,100,100,100,100,100,100,100,100,100,100,100,100,100,100,100,100,100,100,100,100,100,100,100,100,100,100,100,100,100,100,100,100,100,100,100,100,100,100,100,100,100,100,100,100,100,100,100,100,100,100,100,100,100,100,100,100,100,100,100,100,100,100,100,100,100,100
100,100,0,0,0,0,0,0,0,0,0,0,0,0,0,0,0,0,0,0,0,0,0,0,0,0,0,0,0,0,0,0,0,0,0,0,0,0,0,0,0,0,0,0,0,0,0,0,0,0,0,0,0,0,0,0,0,0,0,0,0,0,0,0,0,0,0,0,0,0,0,0,0,0,0,0,0,0,100,100
100,100,0,0,0,0,0,0,0,0,0,0,0,0,0,0,0,0,0,0,0,0,0,0,0,0,0,0,0,0,0,0,0,0,0,0,0,0,0,0,0,0,0,0,0,0,0,0,0,0,0,0,0,0,0,0,0,0,0,0,0,0,0,0,0,0,0,0,0,0,0,0,0,0,0,0,0,0,100,100
100,100,0,0,0,0,0,0,0,0,0,0,0,0,0,0,0,0,0,0,0,0,0,0,0,0,0,0,0,0,0,0,0,0,0,0,0,0,0,0,0,0,0,0,0,0,0,0,0,0,0,0,0,0,0,0,0,0,0,0,0,0,0,0,0,0,0,0,0,0,0,0,0,0,0,0,0,0,100,100
100,100,0,0,100,1,1,1,100,1,1,1,100,1,1,1,100,1,1,1,100,1,1,1,100,1,1,1,100,1,1,1,100,1,1,1,100,1,1,1,100,1,1,1,100,1,1,1,100,1,1,1,100,1,1,1,100,1,1,1,100,1,1,1,100,1,1,1,100,1,1,1,100,1,1,1,0,0,100,100
100,100,0,0,100,1,1,1,100,1,1,1,100,1,1,1,100,1,1,1,100,1,1,1,100,1,1,1,100,1,1,1,100,1,1,1,100,1,1,1,100,1,1,1,100,1,1,1,100,1,1,1,100,1,1,1,100,1,1,1,100,1,1,1,100,1,1,1,100,1,1,1,100,1,1,1,0,0,100,100
100,100,0,0,100,1,1,1,100,1,1,1,100,1,1,1,100,1,1,1,100,1,1,1,100,1,1,1,100,1,1,1,100,1,1,1,100,1,1,1,100,1,1,1,100,1,1,1,100,1,1,1,100,1,1,1,100,1,1,1,100,1,1,1,100,1,1,1,100,1,1,1,100,1,1,1,0,0,100,100
100,100,0,0,100,1,1,1,100,1,1,1,100,1,1,1,100,1,1,1,100,1,1,1,100,1,1,1,100,1,1,1,100,1,1,1,100,1,1,1,100,1,1,1,100,1,1,1,100,1,1,1,100,1,1,1,100,1,1,1,100,1,1,1,100,1,1,1,100,1,1,1,100,1,1,1,0,0,100,100
100,100,0,0,100,100,100,100,100,100,100,100,100,100,100,100,100,100,100,100,100,100,100,100,100,100,100,100,100,100,100,100,100,100,100,100,100,100,100,100,100,100,100,100,100,100,100,100,100,100,100,100,100,100,100,100,100,100,100,100,100,100,100,100,100,100,100,100,100,100,100,100,100,100,100,100,0,0,100,100
100,100,0,0,100,100,100,100,100,100,100,100,100,100,100,100,100,100,100,100,100,100,100,100,100,100,100,100,100,100,100,100,100,100,100,100,100,100,100,100,100,100,100,100,100,100,100,100,100,100,100,100,100,100,100,100,100,100,100,100,100,100,100,100,100,100,100,100,100,100,100,100,100,100,100,100,0,0,100,100
100,100,0,0,100,1,1,1,100,1,1,1,100,1,1,1,100,1,1,1,100,1,1,1,100,1,1,1,100,1,1,1,100,1,1,1,100,1,1,1,100,1,1,1,100,1,1,1,100,1,1,1,100,1,1,1,100,1,1,1,100,1,1,1,100,1,1,1,100,1,1,1,100,1,1,1,0,0,100,100
100,100,0,0,100,1,1,1,100,1,1,1,100,1,1,1,100,1,1,1,100,1,1,1,100,1,1,1,100,1,1,1,100,1,1,1,100,1,1,1,100,1,1,1,100,1,1,1,100,1,1,1,100,1,1,1,100,1,1,1,100,1,1,1,100,1,1,1,100,1,1,1,100,1,1,1,0,0,100,100
100,100,0,0,100,1,1,1,100,1,1,1,100,1,1,1,100,1,1,1,100,1,1,1,100,1,1,1,100,1,1,1,100,1,1,1,100,1,1,1,100,1,1,1,100,1,1,1,100,1,1,1,100,1,1,1,100,1,1,1,100,1,1,1,100,1,1,1,100,1,1,1,100,1,1,1,0,0,100,100
100,100,0,0,100,1,1,1,100,1,1,1,100,1,1,1,100,1,1,1,100,1,1,1,100,1,1,1,100,1,1,1,100,1,1,1,100,1,1,1,100,1,1,1,100,1,1,1,100,1,1,1,100,1,1,1,100,1,1,1,100,1,1,1,100,1,1,1,100,1,1,1,100,1,1,1,0,0,100,100
100,100,0,0,0,0,0,0,0,0,0,0,0,0,0,0,0,0,0,0,0,0,0,0,0,0,0,0,0,0,0,0,0,0,0,0,0,0,0,0,0,0,0,0,0,0,0,0,0,0,0,0,0,0,0,0,0,0,0,0,0,0,0,0,0,0,0,0,0,0,0,0,0,0,0,0,0,0,100,100
100,100,0,0,0,0,0,0,0,0,0,0,0,0,0,0,0,0,0,0,0,0,0,0,0,0,0,0,0,0,0,0,0,0,0,0,0,0,0,0,0,0,0,0,0,0,0,0,0,0,0,0,0,0,0,0,0,0,0,0,0,0,0,0,0,0,0,0,0,0,0,0,0,0,0,0,0,0,100,100
100,100,0,0,0,0,0,0,0,0,0,0,0,0,0,0,0,0,0,0,0,0,0,0,0,0,0,0,0,0,0,0,0,0,0,0,0,0,0,0,0,0,0,0,0,0,0,0,0,0,0,0,0,0,0,0,0,0,0,0,0,0,0,0,0,0,0,0,0,0,0,0,0,0,0,0,0,0,100,100
100,100,0,0,100,1,1,1,100,1,1,1,100,1,1,1,100,1,1,1,100,1,1,1,100,1,1,1,100,1,1,1,100,1,1,1,100,1,1,1,100,1,1,1,100,1,1,1,100,1,1,1,100,1,1,1,100,1,1,1,100,1,1,1,100,1,1,1,100,1,1,1,100,1,1,1,0,0,100,100
100,100,0,0,100,1,1,1,100,1,1,1,100,1,1,1,100,1,1,1,100,1,1,1,100,1,1,1,100,1,1,1,100,1,1,1,100,1,1,1,100,1,1,1,100,1,1,1,100,1,1,1,100,1,1,1,100,1,1,1,100,1,1,1,100,1,1,1,100,1,1,1,100,1,1,1,0,0,100,100
100,100,0,0,100,1,1,1,100,1,1,1,100,1,1,1,100,1,1,1,100,1,1,1,100,1,1,1,100,1,1,1,100,1,1,1,100,1,1,1,100,1,1,1,100,1,1,1,100,1,1,1,100,1,1,1,100,1,1,1,100,1,1,1,100,1,1,1,100,1,1,1,100,1,1,1,0,0,100,100
100,100,0,0,100,1,1,1,100,1,1,1,100,1,1,1,100,1,1,1,100,1,1,1,100,1,1,1,100,1,1,1,100,1,1,1,100,1,1,1,100,1,1,1,100,1,1,1,100,1,1,1,100,1,1,1,100,1,1,1,100,1,1,1,100,1,1,1,100,1,1,1,100,1,1,1,0,0,100,100
100,100,0,0,100,100,100,100,100,100,100,100,100,100,100,100,100,100,100,100,100,100,100,100,100,100,100,100,100,100,100,100,100,100,100,100,100,100,100,100,100,100,100,100,100,100,100,100,100,100,100,100,100,100,100,100,100,100,100,100,100,100,100,100,100,100,100,100,100,100,100,100,100,100,100,100,0,0,100,100
100,100,0,0,100,100,100,100,100,100,100,100,100,100,100,100,100,100,100,100,100,100,100,100,100,100,100,100,100,100,100,100,100,100,100,100,100,100,100,100,100,100,100,100,100,100,100,100,100,100,100,100,100,100,100,100,100,100,100,100,100,100,100,100,100,100,100,100,100,100,100,100,100,100,100,100,0,0,100,100
100,100,0,0,100,1,1,1,100,1,1,1,100,1,1,1,100,1,1,1,100,1,1,1,100,1,1,1,100,1,1,1,100,1,1,1,100,1,1,1,100,1,1,1,100,1,1,1,100,1,1,1,100,1,1,1,100,1,1,1,100,1,1,1,100,1,1,1,100,1,1,1,100,1,1,1,0,0,100,100
100,100,0,0,100,1,1,1,100,1,1,1,100,1,1,1,100,1,1,1,100,1,1,1,100,1,1,1,100,1,1,1,100,1,1,1,100,1,1,1,100,1,1,1,100,1,1,1,100,1,1,1,100,1,1,1,100,1,1,1,100,1,1,1,100,1,1,1,100,1,1,1,100,1,1,1,0,0,100,100
100,100,0,0,100,1,1,1,100,1,1,1,100,1,1,1,100,1,1,1,100,1,1,1,100,1,1,1,100,1,1,1,100,1,1,1,100,1,1,1,100,1,1,1,100,1,1,1,100,1,1,1,100,1,1,1,100,1,1,1,100,1,1,1,100,1,1,1,100,1,1,1,100,1,1,1,0,0,100,100
100,100,0,0,100,1,1,1,100,1,1,1,100,1,1,1,100,1,1,1,100,1,1,1,100,1,1,1,100,1,1,1,100,1,1,1,100,1,1,1,100,1,1,1,100,1,1,1,100,1,1,1,100,1,1,1,100,1,1,1,100,1,1,1,100,1,1,1,100,1,1,1,100,1,1,1,0,0,100,100
100,100,0,0,0,0,0,0,0,0,0,0,0,0,0,0,0,0,0,0,0,0,0,0,0,0,0,0,0,0,0,0,0,0,0,0,0,0,0,0,0,0,0,0,0,0,0,0,0,0,0,0,0,0,0,0,0,0,0,0,0,0,0,0,0,0,0,0,0,0,0,0,0,0,0,0,0,0,100,100
100,100,0,0,0,0,0,0,0,0,0,0,0,0,0,0,0,0,0,0,0,0,0,0,0,0,0,0,0,0,0,0,0,0,0,0,0,0,0,0,0,0,0,0,0,0,0,0,0,0,0,0,0,0,0,0,0,0,0,0,0,0,0,0,0,0,0,0,0,0,0,0,0,0,0,0,0,0,100,100
100,100,0,0,0,0,0,0,0,0,0,0,0,0,0,0,0,0,0,0,0,0,0,0,0,0,0,0,0,0,0,0,0,0,0,0,0,0,0,0,0,0,0,0,0,0,0,0,0,0,0,0,0,0,0,0,0,0,0,0,0,0,0,0,0,0,0,0,0,0,0,0,0,0,0,0,0,0,100,100
100,100,0,0,100,1,1,1,100,1,1,1,100,1,1,1,100,1,1,1,100,1,1,1,100,1,1,1,100,1,1,1,100,1,1,1,100,1,1,1,100,1,1,1,100,1,1,1,100,1,1,1,100,1,1,1,100,1,1,1,100,1,1,1,100,1,1,1,100,1,1,1,100,1,1,1,0,0,100,100
100,100,0,0,100,1,1,1,100,1,1,1,100,1,1,1,100,1,1,1,100,1,1,1,100,1,1,1,100,1,1,1,100,1,1,1,100,1,1,1,100,1,1,1,100,1,1,1,100,1,1,1,100,1,1,1,100,1,1,1,100,1,1,1,100,1,1,1,100,1,1,1,100,1,1,1,0,0,100,100
100,100,0,0,100,1,1,1,100,1,1,1,100,1,1,1,100,1,1,1,100,1,1,1,100,1,1,1,100,1,1,1,100,1,1,1,100,1,1,1,100,1,1,1,100,1,1,1,100,1,1,1,100,1,1,1,100,1,1,1,100,1,1,1,100,1,1,1,100,1,1,1,100,1,1,1,0,0,100,100
100,100,0,0,100,1,1,1,100,1,1,1,100,1,1,1,100,1,1,1,100,1,1,1,100,1,1,1,100,1,1,1,100,1,1,1,100,1,1,1,100,1,1,1,100,1,1,1,100,1,1,1,100,1,1,1,100,1,1,1,100,1,1,1,100,1,1,1,100,1,1,1,100,1,1,1,0,0,100,100
100,100,0,0,100,100,100,100,100,100,100,100,100,100,100,100,100,100,100,100,100,100,100,100,100,100,100,100,100,100,100,100,100,100,100,100,100,100,100,100,100,100,100,100,100,100,100,100,100,100,100,100,100,100,100,100,100,100,100,100,100,100,100,100,100,100,100,100,100,100,100,100,100,100,100,100,0,0,100,100
100,100,0,0,100,100,100,100,100,100,100,100,100,100,100,100,100,100,100,100,100,100,100,100,100,100,100,100,100,100,100,100,100,100,100,100,100,100,100,100,100,100,100,100,100,100,100,100,100,100,100,100,100,100,100,100,100,100,100,100,100,100,100,100,100,100,100,100,100,100,100,100,100,100,100,100,0,0,100,100
100,100,0,0,100,1,1,1,100,1,1,1,100,1,1,1,100,1,1,1,100,1,1,1,100,1,1,1,100,1,1,1,100,1,1,1,100,1,1,1,100,1,1,1,100,1,1,1,100,1,1,1,100,1,1,1,100,1,1,1,100,1,1,1,100,1,1,1,100,1,1,1,100,1,1,1,0,0,100,100
100,100,0,0,100,1,1,1,100,1,1,1,100,1,1,1,100,1,1,1,100,1,1,1,100,1,1,1,100,1,1,1,100,1,1,1,100,1,1,1,100,1,1,1,100,1,1,1,100,1,1,1,100,1,1,1,100,1,1,1,100,1,1,1,100,1,1,1,100,1,1,1,100,1,1,1,0,0,100,100
100,100,0,0,100,1,1,1,100,1,1,1,100,1,1,1,100,1,1,1,100,1,1,1,100,1,1,1,100,1,1,1,100,1,1,1,100,1,1,1,100,1,1,1,100,1,1,1,100,1,1,1,100,1,1,1,100,1,1,1,100,1,1,1,100,1,1,1,100,1,1,1,100,1,1,1,0,0,100,100
100,100,0,0,100,1,1,1,100,1,1,1,100,1,1,1,100,1,1,1,100,1,1,1,100,1,1,1,100,1,1,1,100,1,1,1,100,1,1,1,100,1,1,1,100,1,1,1,100,1,1,1,100,1,1,1,100,1,1,1,100,1,1,1,100,1,1,1,100,1,1,1,100,1,1,1,0,0,100,100
100,100,0,0,0,0,0,0,0,0,0,0,0,0,0,0,0,0,0,0,0,0,0,0,0,0,0,0,0,0,0,0,0,0,0,0,0,0,0,0,0,0,0,0,0,0,0,0,0,0,0,0,0,0,0,0,0,0,0,0,0,0,0,0,0,0,0,0,0,0,0,0,0,0,0,0,0,0,100,100
100,100,0,0,0,0,0,0,0,0,0,0,0,0,0,0,0,0,0,0,0,0,0,0,0,0,0,0,0,0,0,0,0,0,0,0,0,0,0,0,0,0,0,0,0,0,0,0,0,0,0,0,0,0,0,0,0,0,0,0,0,0,0,0,0,0,0,0,0,0,0,0,0,0,0,0,0,0,100,100
100,100,0,0,0,0,0,0,0,0,0,0,0,0,0,0,0,0,0,0,0,0,0,0,0,0,0,0,0,0,0,0,0,0,0,0,0,0,0,0,0,0,0,0,0,0,0,0,0,0,0,0,0,0,0,0,0,0,0,0,0,0,0,0,0,0,0,0,0,0,0,0,0,0,0,0,0,0,100,100
100,100,0,0,100,1,1,1,100,1,1,1,100,1,1,1,100,1,1,1,100,1,1,1,100,1,1,1,100,1,1,1,100,1,1,1,100,1,1,1,100,1,1,1,100,1,1,1,100,1,1,1,100,1,1,1,100,1,1,1,100,1,1,1,100,1,1,1,100,1,1,1,100,1,1,1,0,0,100,100
100,100,0,0,100,1,1,1,100,1,1,1,100,1,1,1,100,1,1,1,100,1,1,1,100,1,1,1,100,1,1,1,100,1,1,1,100,1,1,1,100,1,1,1,100,1,1,1,100,1,1,1,100,1,1,1,100,1,1,1,100,1,1,1,100,1,1,1,100,1,1,1,100,1,1,1,0,0,100,100
100,100,0,0,100,1,1,1,100,1,1,1,100,1,1,1,100,1,1,1,100,1,1,1,100,1,1,1,100,1,1,1,100,1,1,1,100,1,1,1,100,1,1,1,100,1,1,1,100,1,1,1,100,1,1,1,100,1,1,1,100,1,1,1,100,1,1,1,100,1,1,1,100,1,1,1,0,0,100,100
100,100,0,0,100,1,1,1,100,1,1,1,100,1,1,1,100,1,1,1,100,1,1,1,100,1,1,1,100,1,1,1,100,1,1,1,100,1,1,1,100,1,1,1,100,1,1,1,100,1,1,1,100,1,1,1,100,1,1,1,100,1,1,1,100,1,1,1,100,1,1,1,100,1,1,1,0,0,100,100
100,100,0,0,100,100,100,100,100,100,100,100,100,100,100,100,100,100,100,100,100,100,100,100,100,100,100,100,100,100,100,100,100,100,100,100,100,100,100,100,100,100,100,100,100,100,100,100,100,100,100,100,100,100,100,100,100,100,100,100,100,100,100,100,100,100,100,100,100,100,100,100,100,100,100,100,0,0,100,100
100,100,0,0,100,100,100,100,100,100,100,100,100,100,100,100,100,100,100,100,100,100,100,100,100,100,100,100,100,100,100,100,100,100,100,100,100,100,100,100,100,100,100,100,100,100,100,100,100,100,100,100,100,100,100,100,100,100,100,100,100,100,100,100,100,100,100,100,100,100,100,100,100,100,100,100,0,0,100,100
100,100,0,0,100,1,1,1,100,1,1,1,100,1,1,1,100,1,1,1,100,1,1,1,100,1,1,1,100,1,1,1,100,1,1,1,100,1,1,1,100,1,1,1,100,1,1,1,100,1,1,1,100,1,1,1,100,1,1,1,100,1,1,1,100,1,1,1,100,1,1,1,100,1,1,1,0,0,100,100
100,100,0,0,100,1,1,1,100,1,1,1,100,1,1,1,100,1,1,1,100,1,1,1,100,1,1,1,100,1,1,1,100,1,1,1,100,1,1,1,100,1,1,1,100,1,1,1,100,1,1,1,100,1,1,1,100,1,1,1,100,1,1,1,100,1,1,1,100,1,1,1,100,1,1,1,0,0,100,100
100,100,0,0,100,1,1,1,100,1,1,1,100,1,1,1,100,1,1,1,100,1,1,1,100,1,1,1,100,1,1,1,100,1,1,1,100,1,1,1,100,1,1,1,100,1,1,1,100,1,1,1,100,1,1,1,100,1,1,1,100,1,1,1,100,1,1,1,100,1,1,1,100,1,1,1,0,0,100,100
100,100,0,0,100,1,1,1,100,1,1,1,100,1,1,1,100,1,1,1,100,1,1,1,100,1,1,1,100,1,1,1,100,1,1,1,100,1,1,1,100,1,1,1,100,1,1,1,100,1,1,1,100,1,1,1,100,1,1,1,100,1,1,1,100,1,1,1,100,1,1,1,100,1,1,1,0,0,100,100
100,100,0,0,0,0,0,0,0,0,0,0,0,0,0,0,0,0,0,0,0,0,0,0,0,0,0,0,0,0,0,0,0,0,0,0,0,0,0,0,0,0,0,0,0,0,0,0,0,0,0,0,0,0,0,0,0,0,0,0,0,0,0,0,0,0,0,0,0,0,0,0,0,0,0,0,0,0,100,100
100,100,0,0,0,0,0,0,0,0,0,0,0,0,0,0,0,0,0,0,0,0,0,0,0,0,0,0,0,0,0,0,0,0,0,0,0,0,0,0,0,0,0,0,0,0,0,0,0,0,0,0,0,0,0,0,0,0,0,0,0,0,0,0,0,0,0,0,0,0,0,0,0,0,0,0,0,0,100,100
100,100,0,0,0,0,0,0,0,0,0,0,0,0,0,0,0,0,0,0,0,0,0,0,0,0,0,0,0,0,0,0,0,0,0,0,0,0,0,0,0,0,0,0,0,0,0,0,0,0,0,0,0,0,0,0,0,0,0,0,0,0,0,0,0,0,0,0,0,0,0,0,0,0,0,0,0,0,100,100
100,100,0,0,100,100,100,100,100,100,100,100,100,100,100,100,100,100,100,100,100,100,100,100,100,100,100,100,100,100,100,100,100,100,100,100,100,100,100,100,100,100,100,100,100,100,100,100,100,100,100,100,100,100,100,100,100,100,100,100,100,100,100,100,100,100,100,100,100,100,100,100,100,100,100,100,0,0,100,100
100,100,0,0,100,100,100,100,100,100,100,100,100,100,100,100,100,100,100,100,100,100,100,100,100,100,100,100,100,100,100,100,100,100,100,100,100,100,100,100,100,100,100,100,100,100,100,100,100,100,100,100,100,100,100,100,100,100,100,100,100,100,100,100,100,100,100,100,100,100,100,100,100,100,100,100,0,0,100,100
100,100,0,0,100,100,100,100,100,100,100,100,100,100,100,100,100,100,100,100,100,100,100,100,100,100,100,100,100,100,100,100,100,100,100,100,100,100,100,100,100,100,100,100,100,100,100,100,100,100,100,100,100,100,100,100,100,100,100,100,100,100,100,100,100,100,100,100,100,100,100,100,100,100,100,100,0,0,100,100
100,100,0,0,100,100,100,100,100,100,100,100,100,100,100,100,100,100,100,100,100,100,100,100,100,100,100,100,100,100,100,100,100,100,100,100,100,100,100,100,100,100,100,100,100,100,100,100,100,100,100,100,100,100,100,100,100,100,100,100,100,100,100,100,100,100,100,100,100,100,100,100,100,100,100,100,0,0,100,100
100,100,0,0,100,100,100,100,100,100,100,100,100,100,100,100,100,100,100,100,100,100,100,100,100,100,100,100,100,100,100,100,100,100,100,100,100,100,100,100,100,100,100,100,100,100,100,100,100,100,100,100,100,100,100,100,100,100,100,100,100,100,100,100,100,100,100,100,100,100,100,100,100,100,100,100,0,0,100,100
100,100,0,0,100,100,100,100,100,100,100,100,100,100,100,100,100,100,100,100,100,100,100,100,100,100,100,100,100,100,100,100,100,100,100,100,100,100,100,100,100,100,100,100,100,100,100,100,100,100,100,100,100,100,100,100,100,100,100,100,100,100,100,100,100,100,100,100,100,100,100,100,100,100,100,100,0,0,100,100
100,100,0,0,100,100,100,100,100,100,100,100,100,100,100,100,100,100,100,100,100,100,100,100,100,100,100,100,100,100,100,100,100,100,100,100,100,100,100,100,100,100,100,100,100,100,100,100,100,100,100,100,100,100,100,100,100,100,100,100,100,100,100,100,100,100,100,100,100,100,100,100,100,100,100,100,0,0,100,100
