N
30,26
C
100
A
16
12,22,S
19,4
13,22,S
24,4
12,21,S
19,6
13,21,S
24,6
12,20,S
19,10
13,20,S
24,10
12,19,S
19,12
13,19,S
24,16
16,22,S
10,4
17,22,S
5,4
16,21,S
10,6
17,21,S
5,6
16,20,S
10,10
17,20,S
5,10
16,19,S
10,12
17,19,S
5,16
M
100,100,100,100,100,100,100,100,100,100,100,100,100,100,100,100,100,100,100,100,100,100,100,100,100,100,100,100,100,100
100,100,100,100,100,100,100,100,100,100,100,100,100,100,100,100,100,100,100,100,100,100,100,100,100,100,100,100,100,100
100,100,0,0,0,0,0,0,0,0,0,0,0,0,100,100,0,0,0,0,0,0,0,0,0,0,0,0,100,100
100,100,0,0,0,0,0,0,0,0,0,0,0,0,100,100,0,0,0,0,0,0,0,0,0,0,0,0,100,100
100,100,0,0,100,1,1,1,1,1,1,100,0,0,100,100,0,0,100,1,1,1,1,1,1,100,0,0,100,100
100,100,0,0,100,100,100,100,100,100,100,100,0,0,100,100,0,0,100,100,100,100,100,100,100,100,0,0,100,100
100,100,0,0,100,1,1,1,1,1,1,100,0,0,100,100,0,0,100,1,1,1,1,1,1,100,0,0,100,100
100,100,0,0,0,0,0,0,0,0,0,0,0,0,0,0,0,0,0,0,0,0,0,0,0,0,0,0,100,100
100,100,0,0,0,0,0,0,0,0,0,0,0,0,0,0,0,0,0,0,0,0,0,0,0,0,0,0,100,100
100,100,0,0,0,0,0,0,0,0,0,0,0,0,100,100,0,0,0,0,0,0,0,0,0,0,0,0,100,100
100,100,0,0,100,1,1,1,1,1,1,100,0,0,100,100,0,0,100,1,1,1,1,1,1,100,0,0,100,100
100,100,0,0,100,100,100,100,100,100,100,100,0,0,100,100,0,0,100,100,100,100,100,100,100,100,0,0,100,100
100,100,0,0,100,1,1,1,1,1,1,100,0,0,100,100,0,0,100,1,1,1,1,1,1,100,0,0,100,100
100,100,0,0,0,0,0,0,0,0,0,0,0,0,0,0,0,0,0,0,0,0,0,0,0,0,0,0,100,100
100,100,0,0,0,0,0,0,0,0,0,0,0,0,0,0,0,0,0,0,0,0,0,0,0,0,0,0,100,100
100,100,0,0,100,100,100,100,100,100,100,100,0,0,100,100,0,0,100,100,100,100,100,100,100,100,0,0,100,100
100,100,0,0,100,1,1,1,1,1,1,100,0,0,100,100,0,0,100,1,1,1,1,1,1,100,0,0,100,100
100,100,0,0,0,0,0,0,0,0,0,0,0,0,100,100,0,0,0,0,0,0,0,0,0,0,0,0,100,100
100,100,0,0,0,0,0,0,0,0,0,0,0,0,100,100,0,0,0,0,0,0,0,0,0,0,0,0,100,100
100,100,0,0,100,100,100,100,100,100,100,100,0,0,100,100,0,0,100,100,100,100,100,100,100,100,0,0,100,100
100,100,0,0,100,100,100,100,100,100,100,100,0,0,100,100,0,0,100,100,100,100,100,100,100,100,0,0,100,100
100,100,0,0,0,0,0,0,0,0,0,0,0,0,0,0,0,0,0,0,0,0,0,0,0,0,0,0,100,100
100,100,0,0,0,0,0,0,0,0,0,0,0,0,0,0,0,0,0,0,0,0,0,0,0,0,0,0,100,100
100,100,100,100,100,100,100,100,100,100,100,100,100,100,100,100,100,100,100,100,100,100,100,100,100,100,100,100,100,100
100,100,100,100,100,100,100,100,100,100,100,100,100,100,100,100,100,100,100,100,100,100,100,100,100,100,100,100,100,100
100,100,100,100,100,100,100,100,100,100,100,100,100,100,100,100,100,100,100,100,100,100,100,100,100,100,100,100,100,100
